EA textures/path_to_the_east_texture.xpm

C  						 	50, 50,                       50

NO										 textures/path_to_the_north_texture.xpm
WE textures/path_to_the_west_texture.xpm

F               0,		0,      								0






SO 										textures/path_to_the_south_texture.xpm

1111111111
1000000001   1
1001000001
100N100001
10010000001
10011100101
1000010101                          111
1000010101                         111111111
100000001                           111
1111111111





