EA textures/path_to_the_east_texture.xpm

C  						 	0, 0,                       9

NO										 textures/path_to_the_north_texture.xpm
WE textures/path_to_the_west_texture.xpm

F               255,		255,      								255






SO 										textures/path_to_the_south_texture.xpm

1111111111
1000000001
1000000001
100000001
1001000001
1001110101
  1000010101
1000010101
10000N0001
1111111111
