EA textures/path_to_the_east_texture.xpm

C  						 	0, 0,                       9

NO										 textures/path_to_the_north_texture.xpm
WE textures/path_to_the_west_texture.xpm

F               255,		255,      								255






SO 										textures/path_to_the_south_texture.xpm

1111111111
1000000001   1
1000000001
1000000001
10010000001
10011100101
1000010101                          111
1000010101                         111111111		
10000N001                           111
1111111111
