NO textures/path_to_the_north_texture.xpm
SO textures/path_to_the_south_texture.xpm
WE textures/path_to_the_west_texture.xpm
EA textures/path_to_the_east_texture.xpm

F 101,183,65
C 123,211,234

1111111111
1000000001
1000000001
100000W001
1001000001
1001110101         111
1000010101
1000010101
1000000001
1111111111
                                                                                         
				 111
				 101
				 111
